####################
#                  #
#                  #
#  ##############  #
#                  #
#                  #
#########  #########
#                  #
#                  #
#                  #
#                  #
#                  #
#                  #
#                  #
####################
