################
#              #
#   ##    ##   #
#   ##    ##   #
#              #
              
   #         # 
#   #########  #
#              #
#              #
#              #
################
